PPPPPPPPPPPPPPPPPPP
Pe     e   e     eP
P ll    l l    ll P
P ll ll l l ll ll P
P ll ll l l ll ll P
P ll ll lcl ll ll P
P ll ll l l ll ll P
P ll ll     ll ll P
P       l l       P
Pc   ll     ll   cP
P       l l       P
P ll ll lll ll ll P
P ll ll l l ll ll P
P ll ll l l ll ll P
P ll ll l l ll ll P
P ll ll     ll ll P
P       lll       P
P       lxl       P
PPPPPPPPPPPPPPPPPPP